7:9
5:8
3:8
#######
# #  ##
# # # #
#     #
#  ## #
#   # #
#   # #
#   # #
### # #