5:5
1:0
3:4
# ###
#   #
### #
#   #
### #